20:13 
137 0  0   0 0 4 4 1 1 0 0 0 0 0 0 0 0 0  0  0  
0   0  0   0 0 0 0 0 0 0 6 6 6 0 0 0 0 1  0  0 
4   4  4   4 0 4 4 1 1 0 6 6 6 1 0 0 0 0  1  0 
4   4  4   4 0 4 4 1 1 0 6 6 6 6 6 0 0 0  0  0 
1   1  1   1 0 1 1 1 1 0 0 0 0 0 0 1 0 0  0  0 
1   1  1   1 0 1 1 1 1 1 1 1 1 1 0 0 0 0  0  0 
0   0  0   0 0 1 1 1 0 0 0 0 0 0 1 0 0 0  1  0 
0   0  0   0 0 1 1 1 0 0 0 0 0 0 0 1 0 37 0  1 
1   1  1   0 0 1 1 1 0 0 0 0 0 0 0 0 1 69 69 1 
1   41 84  0 0 1 1 1 0 0 0 0 0 0 0 0 0 1  8  1 
1   1  100 0 0 1 1 1 0 0 1 0 0 0 0 0 0 0  0  1 
4   4  84  0 0 1 1 1 0 0 1 57 0 0 0 0 0 0  0  1 
4   68 0   0 0 1 1 1 0 0 1 1 1 0 0 0 0 0  0  0 
