20:13 
0 0   0  0 0 4 4 1 1 0   0  0  0  0   0     0   0   0 0 0  
0 0   0  0 0 0 0 0 0 0   0  17 0  0   0     0   0   0 1 0 
4 4   4  4 0 4 4 1 1 0   17 1  17 0   0     0   0   0 0 0 
4 4   4  4 0 4 4 1 1 0   0  0  0  0   0     0   0   0 0 0 
1 1   1  1 0 1 1 1 1 0   0  0  0  0   0     0   0   0 0 0 
1 1   1  1 0 1 1 1 1 1   1  1  1  1   0     0   0   0 0 0 
0 0   0  0 0 1 1 1 0 233 0  0  0  0   1     0   0   0 0 0 
0 0   0  0 0 1 1 1 0 0   0  0  0  0   1     1   0   0 0 0 
1 1   1  0 0 1 1 1 1 1   0  0  0  0   0     0   1   0 0 0 
1 0   0  0 0 1 1 1 1 1   0  0  0  0   0     0   0   1 0 0 
1 1   0  0 0 1 1 1 1 1   0  0  1  0   0     0   1   0 1 0 
4 4   84 0 0 1 1 1 0 0   1  1  1  101 101   101 1   0 0 1 
0 68  0  0 0 1 1 1 0 0   1  1  1  101 3     101 101 0 0 0  
