20:13 
0 0   0  0 0 4  4 1 1   0 0 0 0 0 0 0 0   0 0 0  
0 0   0  0 0 0  0 0 0   0 0 0 0 0 0 0 0   0 0 0 
4 4   4  4 0 4  4 1 1   0 0 0 0 0 0 0 0   0 0 0 
4 4   4  4 0 4  4 1 1   0 0 0 0 0 0 0 105 0 0 0 
1 1   1  1 0 1  1 1 1   0 0 0 0 0 0 0 0   0 0 0 
1 1   17 1 0 1  1 1 1   1 1 1 1 1 0 0 0   0 0 0 
0 0   0  0 0 6  1 1 249 0 0 0 0 0 1 0 0   0 0 0 
0 201 0  0 0 1  1 1 0   0 0 0 0 0 0 1 0   0 0 0 
1 1   1  0 0 37 6 1 0   0 0 0 0 0 0 0 1   0 0 0 
1 0   0  0 0 1  1 1 0   0 0 0 0 0 0 0 0   1 0 0 
1 1   0  0 0 1  1 1 0   0 0 0 0 0 0 0 0   0 1 0 
4 4   84 0 0 1  1 1 0   0 0 0 0 0 0 0 0   0 0 1 
0 68  0  0 0 1  1 1 0   0 0 0 0 0 0 0 0   0 0 0 
