30:15 
37 0  1  1  4  0  0  1  0  0 25 0  0  1  0  0  0  0  0  0 17 0  0  17 0  1 1 0  4 0 
2  0  0  0  4  1  1  4  17 8 0  0  0  1  1  0  0  0  4  0 0  0  1  0  0  0 0 4  0 0 
0  0  0  0  4  0  0  0  0  0 0  1  17 1  1  4  0  0  4  0 0  0  0  0  0  0 1 0  0 0 
1  1  0  0  68 0  0  6  0  1 1  0  1  1  1  4  17 4  0  0 0  0  69 0  17 0 0 0  0 69 
0  0  0  0  1  0  1  0  0  1 0  0  4  0  0  0  17 0  0  0 1  0  84 0  0  1 1 1  0 0 
1  0  0  6  17 1  1  17 17 0 0  1  4  0  0  21 0  17 0  1 0  0  17 21 0  0 0 1  0 4 
1  17 17 17 17 17 17 17 17 1 0  0  0  0  4  0  0  0  0  0 1  1  0  0  0  0 0 0  1 0 
0  0  0  1  4  0  0  0  0  0 0  0  0  1  0  0  0  0  0  0 4  0  0  0  1  1 0 0  0 1 
0  4  0  4  0  1  1  0  0  0 0  1  0  0  1  0  0  8  0  0 0  0  0  1  0  1 0 17 0 0 
0  0  1  0  0  1  0  0  0  4 0  0  17 0  0  0  1  0  17 0 0  17 4  0  0  0 1 6  0 0  
0  4  0  1  0  0  4  0  0  0 0  0  0  0  0  0  0  17 17 0 17 0  1  0  0  1 0 1  0 0 
0  0  17 0  0  0  0  4  4  1 0  17 1  4  0  0  0  6  0  0 0  0  0  1  0  1 0 0  0 1 
0  1  0  1  0  0  0  4  0  1 0  0  0  20 0  0  1  0  0  1 0  0  4  0  0  1 0 17 1 0 
0  69 0  17 0  0  0  0  0  4 0  1  0  0  17 1  1  0  0  1 0  0  0  0  0  0 0 4  1 0 
6  0  0  1  0  0  0  17 0  4 0  0  0  1  0  4  0  1  0  4 0  0  0  1  0  0 4 0  0 0 
