30:15 
1 0  17  0 0  1  0  1 0  17 0  0   0   0  0  1  1  1  0  1  0   0  17  0  0  4  201 0  0  1 
0 0  17  0 0  0  0  0 0  0  0  153 0   0  0  0  1  0  17 0  0   0  17  1  84 1  0   0  1  0  
1 4  0   0 0  0  1  1 0  0  0  0   1   1  0  0  1  17 0  1  4   0  17  0  0  84 84  17 1  1 
1 1  1   1 17 0  0  1 1  0  0  17  0   0  1  1  0  1  37 1  0   0  17  0  17 17 0   1  0  0 
4 0  0   0 0  0  0  0 0  0  0  0   17  0  4  1  1  0  0  0  6   0  17  0  0  0  1   1  0  1 
0 0  100 0 0  1  17 0 0  0  1  1   69  17 1  4  0  1  0  0  0   0  17  0  0  0  84  0  0  17 
1 4  1   4 1  1  1  1 1  1  1  8   4   0  17 1  0  0  0  0  101 0  17  0  1  0  84  0  17 21 
0 17 4   0 1  0  0  0 1  0  1  36  4   0  0  57 0  4  17 0  0   0  17  0  0  0  84  8  0  0 
4 1  0   1 0  0  0  0 17 0  53 0   101 0  0  0  0  1  0  0  0   0  1   17 17 4  17  17 0  0 
0 0  0   1 0  21 17 0 1  0  0  0   0   0  0  1  0  0  0  0  0   84 0   1  0  0  0   17 1  1 
4 0  0   0 0  0  36 0 4  0  1  17  0   0  0  0  0  1  0  0  0   17 0   17 1  1  0   1  17 0 
0 0  0   0 4  0  0  0 0  0  0  4   0   17 17 0  0  4  1  17 0   17 0   1  17 0  0   1  6  6 
0 0  1   0 17 0  0  0 17 4  1  0   17  0  0  0  0  4  0  1  0   37 17  1  0  0  4   4  6  6 
0 0  0   1 0  0  1  0 0  0  0  17  0   17 0  1  0  52 0  0  0   69 0   17 4  0  4   6  17 4 
0 0  0   0 0  21 17 1 0  0  1  4   0   17 1  0  1  0  4  1  0   0  0   17 0  0  4   6  8  4 
