20:13 
185 0  0  0 4   4 1  1  0 0  0 0 0 0 0 0 0 0  0 0
0   0  0  0 101 0 0  4  0 0  0 0 0 0 0 0 0 41 0 0 
4   4  4  4 0   4 4  1  1 0  0 0 0 0 0 0 0 0  0 0 
4   4  4  4 0   4 4  1  1 0  0 0 0 0 0 0 0 0  0 0 
1   1  1  1 0   4 4  1  1 0  0 0 0 0 0 0 0 0  0 0 
1   1  1  1 0   4 4  1  1 17 1 1 1 1 1 0 0 0  0 0 
6   6  6  6 0   4 4  1  0 0  0 0 0 0 4 0 0 0  0 0 
6   6  0  6 0   4 4  1  0 0  0 0 0 8 4 4 0 0  0 0 
1   1  1  0 0   0 6  4  0 0  0 0 0 0 4 4 4 0  0 0 
1   0  0  0 6   4 0  0  0 0  0 0 0 0 0 0 0 1  0 0 
1   1  0  6 0   4 0  4  0 0  0 6 6 6 0 0 0 0  1 0 
4   4  84 0 0   0 6  4  0 0  0 6 6 6 0 0 0 0  0 1 
8   68 0  0 0   4 4  1  0 0  0 0 6 6 0 0 0 89 0 0 
