20:13 
217 0 0 0 4 0 0 0 0 0 0 0 0  0 0 0  0   0 0  0 
0   0 0 0 4 0 0 1 1 6 6 0 0  6 0 6  0   0 0  0 
4   4 4 4 4 0 1 0 0 1 1 1 1  1 1 1  1   1 0  0 
1   1 1 1 1 1 0 0 6 6 0 0 0  6 0 0  0   0 1  0 
0   0 0 0 0 0 0 1 1 0 6 0 0  0 1 4  1   0 0  0 
0   6 6 6 6 0 4 1 1 1 1 1 1  6 6 1  101 1 1  1 
0   0 0 0 6 4 0 0 0 0 4 0 0  1 6 6  101 1 0  0 
0   0 0 0 0 0 0 0 0 0 0 0 17 1 6 6  6   1 0  0 
1   6 1 1 1 0 0 0 0 0 6 0 0  1 1 1  1   0 0  0 
0   0 0 0 6 0 0 1 6 0 0 0 0  0 0 0  0   0 0  0 
0   0 0 0 0 0 6 6 6 6 0 0 0  0 0 21 21  0 0  17 
0   0 0 0 0 0 0 0 0 0 0 0 0  0 0 21 121 4 17 17 
0   0 0 0 0 0 0 0 0 0 0 0 0  0 0 21 17  4 17 17 
