20:13 
73  0   0  0 0 4 4 1   1   0  0 0 0 0 0 0 0 0 0  0  
0   0   0  0 0 0 0 0   0   0  0 0 0 0 0 0 0 0 0  0 
4   4   4  4 0 4 4 1   1   0  0 0 0 0 0 0 0 1 1  0 
4   4   4  4 0 4 4 1   1   0  0 0 0 0 0 0 0 1 8  100 
1   1   1  1 0 1 1 1   1   0  0 0 0 0 0 0 0 1 1  0 
1   1   1  1 0 1 1 1   1   1  1 1 1 1 0 0 0 0 0  0 
0   0   0  0 0 1 1 1   101 0  0 6 0 0 1 0 0 0 0  0 
0   0   0  0 0 1 1 1   0   0  0 0 4 0 0 1 0 0 0  0 
1   1   1  0 0 1 1 153 0   0  0 4 4 4 0 0 1 0 0  0 
1   169 0  0 0 1 1 1   1   1  0 4 6 0 0 0 0 1 0  0 
1   1   0  0 0 1 1 1   1   1  1 0 6 0 0 0 0 0 1  0 
4   4   84 0 0 1 1 1   0   0  0 6 0 0 0 0 0 0 21 1 
4   68  0  0 0 1 1 1   0   37 0 0 0 0 4 4 0 1 8  0 
